32.29
40-30
0:0 0:0 0:0 0:0 0:0 0:0 0:0 0:0 0:0 0:0 0:0 0:0 0:0 0:0 0:0 0:0 0:0 0:0 0:0 0:0 0:0 0:0 0:0 1:3 1:3 1:3 1:3 1:3 1:2 1:3 1:3 1:3 1:3 1:1 1:1 1:1 1:1 1:1 0:0 0:0 
0:0 0:0 0:0 0:0 0:0 0:0 0:0 0:0 0:0 0:0 0:0 0:0 0:0 0:0 0:0 0:0 0:0 0:0 0:0 0:0 0:0 0:0 0:0 1:3 1:3 1:3 1:3 1:3 1:3 1:3 1:3 1:3 1:3 0:0 1:3 1:3 1:3 1:3 1:3 1:3 
0:0 0:0 0:0 0:0 0:0 0:0 0:0 0:0 0:0 0:0 0:0 0:0 0:0 0:0 0:0 0:0 0:0 0:0 0:0 0:0 0:0 0:0 0:0 1:3 1:3 1:3 1:3 1:3 1:3 1:3 1:3 1:3 1:3 0:0 1:3 1:3 1:3 1:3 1:3 1:3 
0:0 0:0 0:0 0:0 0:0 0:0 0:0 0:0 0:0 0:0 0:0 0:0 0:0 0:0 0:0 0:0 0:0 0:0 0:0 0:0 0:0 0:0 0:0 1:3 1:3 1:3 1:3 1:3 1:3 1:3 1:3 1:3 1:3 0:0 1:3 1:3 1:3 1:3 1:3 1:3 
0:0 0:0 0:0 0:0 0:0 0:0 0:0 0:0 0:0 0:0 0:0 0:0 0:0 0:0 0:0 0:0 0:0 0:0 0:0 0:0 0:0 0:0 0:0 1:3 1:3 1:3 1:3 1:3 1:3 1:3 1:3 1:3 1:3 0:0 1:3 1:3 1:3 1:3 1:3 1:3 
0:0 0:0 0:0 0:0 0:0 0:0 0:0 0:0 0:0 0:0 0:0 0:0 0:0 0:0 0:0 0:0 1:1 1:1 1:1 1:1 1:1 1:1 1:1 1:3 1:3 1:3 1:3 1:3 1:3 1:3 1:3 1:3 1:3 1:3 1:3 1:3 1:3 1:2 1:3 1:3 
0:0 0:0 0:0 0:0 0:0 0:0 0:0 0:0 0:0 0:0 0:0 0:0 0:0 0:0 0:0 0:0 1:1 0:0 0:0 0:0 0:0 0:0 0:0 0:0 0:0 0:0 0:0 0:0 1:1 0:0 0:0 0:0 0:0 1:3 1:3 1:3 1:3 1:3 1:3 1:3 
0:0 0:0 0:0 0:0 0:0 0:0 0:0 0:0 0:0 0:0 0:0 0:0 0:0 0:0 0:0 0:0 1:1 0:0 0:0 0:0 0:0 0:0 0:0 0:0 0:0 0:0 0:0 0:0 1:1 0:0 0:0 0:0 0:0 1:3 1:3 1:3 1:3 1:3 1:3 1:3 
0:0 0:0 0:0 0:0 0:0 0:0 0:0 0:0 0:0 0:0 0:0 0:0 0:0 0:0 0:0 0:0 1:1 0:0 0:0 0:0 0:0 0:0 0:0 1:3 1:3 1:3 1:3 1:3 1:3 1:3 0:0 0:0 0:0 1:3 1:3 1:3 1:3 1:3 1:3 1:3 
0:0 0:0 0:0 0:0 0:0 0:0 0:0 0:0 0:0 0:0 0:0 0:0 0:0 0:0 0:0 0:0 1:1 0:0 0:0 0:0 0:0 0:0 0:0 1:3 1:3 1:3 1:3 1:3 1:3 1:3 0:0 0:0 0:0 1:3 1:3 1:3 1:3 1:3 1:3 1:3 
0:0 0:0 0:0 0:0 0:0 0:0 0:0 0:0 0:0 0:0 0:0 0:0 0:0 0:0 0:0 0:0 1:1 0:0 0:0 0:0 0:0 0:0 0:0 1:3 1:3 1:3 1:3 1:3 1:3 1:3 0:0 0:0 0:0 1:3 1:3 1:3 1:3 2:4 1:3 1:3 
0:0 0:0 0:0 0:0 0:0 0:0 0:0 0:0 0:0 0:0 0:0 0:0 0:0 0:0 0:0 0:0 1:1 0:0 0:0 0:0 0:0 1:3 1:3 1:3 1:3 1:3 1:2 1:3 1:3 1:3 1:3 1:1 1:1 1:3 1:3 1:3 1:3 1:3 1:3 1:2 
0:0 0:0 0:0 0:0 0:0 0:0 0:0 0:0 0:0 0:0 0:0 0:0 0:0 0:0 0:0 0:0 1:1 0:0 0:0 0:0 0:0 1:3 1:3 1:3 1:3 1:3 1:3 1:3 1:3 1:3 1:3 0:0 0:0 1:3 1:3 1:3 1:3 1:3 1:3 1:3 
0:0 0:0 0:0 0:0 0:0 0:0 0:0 0:0 0:0 0:0 0:0 0:0 0:0 0:0 0:0 0:0 1:1 0:0 0:0 0:0 0:0 1:3 1:3 1:3 1:3 1:3 1:3 1:3 1:3 1:3 1:3 0:0 0:0 1:3 1:3 1:3 1:3 1:3 1:3 1:3 
0:0 0:0 0:0 0:0 0:0 0:0 0:0 0:0 0:0 0:0 0:0 0:0 0:0 0:0 0:0 0:0 1:1 0:0 0:0 0:0 0:0 1:3 1:3 1:3 1:3 1:3 1:3 1:3 1:3 1:3 1:3 0:0 0:0 0:0 0:0 1:3 1:3 1:3 1:3 1:3 
0:0 0:0 0:0 0:0 0:0 0:0 0:0 0:0 0:0 0:0 0:0 0:0 0:0 1:3 1:3 1:3 1:3 1:3 1:3 1:3 0:0 1:3 1:3 1:3 1:3 1:3 1:3 1:3 1:3 1:3 1:3 0:0 0:0 0:0 0:0 1:3 1:3 1:3 1:3 1:3 
0:0 0:0 0:0 0:0 0:0 0:0 0:0 0:0 0:0 0:0 0:0 0:0 0:0 1:3 1:3 1:3 1:3 1:3 1:3 1:3 0:0 1:3 1:3 1:3 1:3 1:3 1:2 1:3 1:3 1:3 1:3 1:1 1:1 1:1 1:1 1:3 1:3 1:3 1:3 1:3 
0:0 0:0 0:0 0:0 0:0 0:0 0:0 0:0 0:0 0:0 0:0 0:0 0:0 1:3 1:3 1:3 1:3 1:3 1:3 1:3 0:0 1:3 1:3 1:3 1:3 1:3 1:3 1:3 1:3 1:3 1:3 0:0 0:0 0:0 0:0 0:0 0:0 0:0 0:0 1:1 
0:0 0:0 0:0 0:0 0:0 0:0 0:0 0:0 0:0 0:0 0:0 0:0 0:0 1:3 1:3 1:3 1:2 1:3 1:3 1:3 1:1 1:3 1:3 1:3 1:3 1:3 1:3 1:3 1:3 1:3 1:3 1:1 1:1 1:1 1:1 1:1 1:1 1:1 1:1 1:1 
0:0 0:0 0:0 0:0 0:0 0:0 0:0 0:0 0:0 0:0 0:0 0:0 0:0 1:3 1:3 1:3 1:3 1:3 1:3 1:3 0:0 1:3 1:3 1:3 1:3 1:3 1:3 1:3 1:3 1:3 1:3 0:0 0:0 0:0 0:0 0:0 0:0 0:0 0:0 0:0 
0:0 0:0 0:0 0:0 0:0 0:0 0:0 0:0 0:0 0:0 0:0 0:0 0:0 1:3 1:3 1:3 1:3 1:3 1:3 1:3 0:0 0:0 0:0 0:0 0:0 0:0 0:0 0:0 1:1 0:0 0:0 0:0 0:0 0:0 0:0 0:0 0:0 0:0 0:0 0:0 
0:0 0:0 0:0 0:0 0:0 0:0 0:0 0:0 0:0 0:0 0:0 0:0 0:0 1:3 1:3 1:3 1:3 1:3 1:3 1:3 0:0 0:0 0:0 0:0 0:0 0:0 0:0 0:0 1:1 0:0 0:0 0:0 0:0 0:0 0:0 0:0 0:0 0:0 0:0 0:0 
0:0 0:0 0:0 0:0 0:0 0:0 0:0 0:0 0:0 0:0 0:0 0:0 0:0 0:0 0:0 0:0 0:0 0:0 0:0 0:0 0:0 0:0 0:0 0:0 0:0 0:0 0:0 0:0 1:1 0:0 0:0 0:0 0:0 0:0 0:0 0:0 0:0 0:0 0:0 0:0 
0:0 0:0 0:0 0:0 0:0 0:0 0:0 0:0 0:0 0:0 0:0 0:0 0:0 0:0 0:0 0:0 0:0 0:0 0:0 0:0 0:0 0:0 0:0 0:0 0:0 0:0 0:0 0:0 1:1 0:0 0:0 0:0 0:0 0:0 0:0 0:0 0:0 0:0 0:0 0:0 
0:0 0:0 0:0 0:0 0:0 0:0 0:0 0:0 0:0 0:0 0:0 0:0 0:0 0:0 0:0 0:0 0:0 0:0 0:0 0:0 0:0 0:0 0:0 0:0 0:0 0:0 0:0 0:0 1:1 1:3 1:3 1:3 1:3 1:3 1:3 1:3 0:0 0:0 0:0 0:0 
0:0 0:0 0:0 0:0 0:0 0:0 0:0 0:0 0:0 0:0 0:0 0:0 0:0 0:0 0:0 0:0 0:0 0:0 0:0 0:0 0:0 0:0 0:0 0:0 0:0 0:0 0:0 0:0 1:1 1:3 1:3 1:3 1:3 1:3 1:3 1:3 0:0 0:0 0:0 0:0 
0:0 0:0 0:0 0:0 0:0 0:0 0:0 0:0 0:0 0:0 0:0 0:0 0:0 0:0 0:0 0:0 0:0 0:0 0:0 0:0 0:0 0:0 0:0 0:0 0:0 0:0 0:0 0:0 1:1 1:3 1:3 1:3 1:3 1:3 1:3 1:3 0:0 0:0 0:0 0:0 
0:0 0:0 0:0 0:0 0:0 0:0 0:0 0:0 0:0 0:0 0:0 0:0 0:0 0:0 0:0 0:0 0:0 0:0 0:0 0:0 0:0 0:0 0:0 0:0 0:0 0:0 0:0 0:0 1:1 1:3 1:3 1:3 1:3 1:3 1:3 1:3 0:0 0:0 0:0 0:0 
0:0 0:0 0:0 0:0 0:0 0:0 0:0 0:0 0:0 0:0 0:0 0:0 0:0 0:0 0:0 0:0 0:0 0:0 0:0 0:0 0:0 0:0 0:0 0:0 0:0 0:0 0:0 0:0 1:1 1:3 1:3 1:3 1:3 1:3 1:3 1:3 0:0 0:0 0:0 0:0 
0:0 0:0 0:0 0:0 0:0 0:0 0:0 0:0 0:0 0:0 0:0 0:0 0:0 0:0 0:0 0:0 0:0 0:0 0:0 0:0 0:0 0:0 0:0 0:0 0:0 0:0 0:0 0:0 1:1 1:3 1:3 1:3 1:2 1:3 1:3 1:3 0:0 0:0 0:0 0:0 

Gold:
28,28,97
Item:
28,27,1,0,3,0,0,0,2
Gold:
28,26,46
Item:
28,25,1,0,3,0,0,2,2
Gold:
28,23,47
Gold:
28,21,86
Item:
28,20,1,0,3,0,0,0,2
Gold:
28,19,84
Item:
28,16,1,0,3,0,0,2,2
Item:
28,14,1,0,3,0,0,0,2
Gold:
28,11,68
Gold:
28,9,64
Item:
28,8,0,0,0,0,1,1,1
Gold:
28,7,86
Item:
28,6,1,0,3,0,0,2,2
Item:
28,5,0,0,0,1,0,0,1
Gold:
28,3,36
Item:
28,1,1,0,3,0,0,2,2
Enemy:
29,0,4,6,0,4,200,4,0
Gold:
37,2,9
Item:
16,7,0,0,0,0,1,1,1
Item:
16,9,0,0,0,1,0,0,1
Gold:
16,11,80
Item:
16,14,1,3,0,0,0,1,2
Item:
16,16,0,0,0,0,1,1,1
Item:
16,18,1,0,3,0,0,2,2
Item:
39,17,1,0,3,0,0,2,2
Gold:
39,13,22
Gold:
39,11,20
Item:
26,14,1,0,3,0,0,2,2
Item:
26,16,1,3,0,0,0,1,2
Gold:
37,14,48
Gold:
37,13,38
Enemy:
29,0,4,6,0,4,200,4,0
